##########
#A# ####B#
#      # #
## ###   #
##########
