##########
# # ####B#
#      # #
## ###   #
##########