##########
#A# ####B#
#A     # #
## ###   #
##########