##########
#A# ####B#
#     ## #
## ###   #
##########