##########
#A# ####B#
#......#.#
## ###...#
##########
